xxFxx
xxBxx
xxAxx
xUxBx
xBxAx
xxSxx